%%%%%%%%%%%%%%%
%.          . %
%%%.%%%.%%.%% %
%      P  .   %
%%%%%% %%%o%% %
%...          %
%%%%%%%%%%%%%%%