%%%%%%%
%     %
%   %%%
%     %
%%% %%%
%P    %
%%%%%%%