%%%%%%%
%    .%
%   %%%
%   ..%
%%% %%%
%oP   %
%%%%%%%