%%%%%%%
%    o%
%..  %%
%   ..%
%%% %%%
%P   .%
%%%%%%%