%%%%%%%%%%%%%%%
%      P    . %
%             %
%.         .  %
% ..   ..     %
%            .%
% o           %
%%%%%%%%%%%%%%%