%%%%%%%%%%%%%%%
%             %
%.... ....   o%
%%%%% %%%%%%%%%
%             %
%%%%% %%%%%%%%%
%            P%
%%%%%%%%%%%%%%%